"aa" = (/turf,/area)
"ab" = (/turf/earth/outside/grass,/area)
"ac" = (/turf/earth/outside/grass,/turf/earth/outside/fence/left,/area)
"ad" = (/turf/earth/outside/grass,/turf/earth/outside/fence,/area)
"ae" = (/turf/earth/outside/grass,/turf/earth/outside/tarmac/top,/area)
"af" = (/turf/earth/outside/grass,/turf/earth/outside/fence/right,/area)
"ag" = (/turf/earth/outside/tarmac,/turf/earth/outside/tarmac/left,/area)
"ah" = (/turf/earth/outside/tarmac,/turf/earth/outside/roadline/bottom,/area)
"ai" = (/turf/earth/outside/tarmac,/turf/earth/outside/tarmac/right,/area)
"aj" = (/turf/earth/outside/tarmac,/turf/earth/outside/tarmac/left,/turf/earth/outside/roadline/right,/area)
"ak" = (/turf/earth/outside/tarmac,/turf/earth/outside/roadline/left,/turf/earth/outside/roadline/top,/area)
"al" = (/turf/earth/outside/tarmac,/turf/earth/outside/roadline/top,/area)
"am" = (/turf/earth/outside/tarmac,/turf/earth/outside/roadline/right,/turf/earth/outside/roadline/top,/area)
"an" = (/turf/earth/outside/tarmac,/turf/earth/outside/tarmac/right,/turf/earth/outside/roadline/left,/area)
"ao" = (/turf/earth/outside/grass,/turf/earth/outside/tarmac/bottom,/area)
"ap" = (/turf/earth/outside/grass,/turf/earth/outside/fence,/turf/earth/outside/fence/left,/area)
"aq" = (/turf/earth/outside/grass,/turf/earth/outside/tile/curb_top,/area)
"ar" = (/turf/earth/outside/tarmac,/turf/earth/outside/roadline/left,/turf/earth/outside/roadline/bottom,/area)
"as" = (/turf/earth/outside/tarmac,/turf/earth/outside/roadline/bottom,/turf/earth/outside/tarmac/right,/area)
"at" = (/turf/earth/outside/tarmac,/turf/earth/outside/tarmac/right,/turf/earth/outside/roadline/top,/area)
"au" = (/turf/earth/outside/tarmac,/turf/earth/outside/roadline/bottom,/turf/earth/outside/roadline/left,/area)
"av" = (/turf/earth/outside/tarmac,/turf/earth/outside/roadline/bottom,/turf/earth/outside/roadline/right,/area)
"aw" = (/turf/earth/outside/tarmac,/turf/earth/outside/roadline/top,/turf/earth/outside/roadline/right,/area)
"ax" = (/turf/earth/outside/tarmac,/turf/earth/outside/roadline/top,/turf/earth/outside/roadline/left,/area)
"ay" = (/turf/earth/outside/tile/small,/turf/earth/outside/tile/curb_right,/area)
"az" = (/turf/earth/outside/tile/large,/area)
"aA" = (/turf/earth/outside/tile/large,/turf/earth/outside/tarmac/top,/area)
"aB" = (/turf/earth/outside/tile/small,/turf/earth/outside/tile/curb_left,/turf/earth/outside/fence/left,/area)
"aC" = (/turf/earth/outside/grass,/turf/earth/outside/grass/flower,/area)
"aD" = (/turf/earth/outside/grass,/turf/earth/outside/grass/bush,/area)
"aE" = (/turf/earth/outside/tile/small,/turf/earth/outside/tile/curb_top,/turf/earth/outside/tile/curb_left,/turf/earth/outside/fence/left,/area)
"aF" = (/turf/earth/outside/grass,/turf/earth/outside/tile/curb_top,/turf/earth/outside/fence,/area)
"aG" = (/turf/earth/outside/tile/small,/turf/earth/outside/tile/curb_left,/area)
"aH" = (/turf/earth/outside/tile/large,/turf/earth/outside/tarmac/bottom,/area)
"aI" = (/turf/earth/outside/tile/small,/turf/earth/outside/tile/curb_bot,/turf/earth/outside/tile/curb_left,/area)
"aJ" = (/turf/earth/outside/grass,/turf/earth/outside/tile/curb_bot,/area)
"aK" = (/turf/earth/outside/tile/small,/turf/earth/outside/tile/curb_bot,/turf/earth/outside/tile/curb_right,/area)
"aL" = (/turf/earth/outside/grass,/turf/earth/outside/grass/flower,/turf/houses/urahara_house,/area)
"aM" = (/turf/earth/inside/wall/white/center,/turf/earth/inside/wall/white/left,/area)
"aN" = (/turf/earth/inside/wall/white/center,/area)
"aO" = (/turf/earth/inside/wall/white/center,/turf/earth/inside/wall/white/right,/area)
"aP" = (/turf/earth/inside/floor/wood,/turf/earth/inside/wall/white/left,/area)
"aQ" = (/turf/earth/inside/floor/wood,/area)
"aR" = (/turf/earth/inside/floor/wood,/turf/earth/inside/wall/white/right,/area)
"aS" = (/turf/earth/outside/grass,/turf/warp/earth/urahara/inn,/area)
"aT" = (/turf/earth/inside/floor/wood,/turf/earth/inside/wall/white/door,/turf/warp/earth/urahara/out,/area)
"aU" = (/turf/void/opaque,/area)
"aV" = (/turf/void/opaque,/turf/earth/inside/wall/white/left,/area)
"aW" = (/turf/void/opaque,/turf/earth/inside/wall/white/right,/area)
"aX" = (/obj/training/Attack,/turf/earth/inside/floor/wood,/area)
"aY" = (/obj/training/Reiatsu,/turf/earth/inside/floor/wood,/area)
"aZ" = (/obj/training/Hierro,/turf/earth/inside/floor/wood,/area)
"ba" = (/obj/training/GMTraining/Attack,/turf/earth/inside/floor/wood,/area)
"bb" = (/obj/training/GMTraining/Reiatsu,/turf/earth/inside/floor/wood,/area)
"bc" = (/obj/training/GMTraining/Hierro,/turf/earth/inside/floor/wood,/area)
"bd" = (/mob/NPC/Zaraki,/turf/earth/outside/grass,/area)
"be" = (/mob/NPC/Byakuya,/turf/earth/outside/grass,/area)
"bf" = (/turf/void/density,/area)
"bg" = (/mob/NPC/Grimjow,/turf/earth/outside/grass,/area)
"bh" = (/mob/NPC/Ulquiorra,/turf/earth/outside/grass,/area)
"bi" = (/mob/NPC/ShinigamiTeacher,/turf/earth/inside/floor/wood,/area)
"bj" = (/mob/NPC/Barber,/turf/earth/inside/floor/wood,/area)
"bk" = (/obj/huge_gargantua,/turf/earth/outside/grass,/area)

(1,1,1) = {"
abababababababababababababababababababababababababababababababababababababababababababababababababab
abababababababababababababababababababababababababababababababababababababababababababababababababab
abababababababababababababababababababababababababababababababababababababababababababababababababab
abababababababababababababababababababababababababababababababababababababababababababababababababab
abababababababababababababababababababababababababababababababababababababababababababababababababab
abababababababababababababababababababababababababababababababababababababababababababababababababab
abababababababababababababababababababababababababababababababababababababababababababababababababab
abababababababababababababababababababababababababababababababababababababababababababababababababab
abababababababababababababababababababababababababababababababababababababababababababababababababab
abababababababababababababababababababababababababababababababababababababababababababababababababab
abababababababababababababababababababababababababababababababababababababababababababababababababab
abababababababababababababababababababababababababababababababababababababababababababababababababab
abababababababababababababababababababababababababababababababababababababababababababababababababab
abababababababababababababababababababababababababababababababababababababababababababababababababab
abababababababababababababababababababababababababababababababababababababababababababababababababab
abababababababababababababababababababababababababababababababababababababababababababababababababab
abababababababababababababababababababababababababababababababababababababababababababababababababab
abababababababababababababababababababababababababababababababababababababababababababababababababab
abababababababababababababababababababababababababababababababababababababababababababababababababab
abababababababababababababababababababababababababababababababababababababababababababababababababab
abababababababababababababababababababababababababababababababababababababababababababababababababab
abababababababababababababababababababababababababababababababababababababababababababababababababab
ababababababababababababababababababacadadadadadadadadadafababababababababababababababababababababab
ababababababababababababababababababacabababababababababafababababababababababababababababababababab
ababababababababababababababababababacabababababababababafababababababababababababababababababababab
ababadadadadadadadadadadadadadadadadapabababababababababafababababababababababababababababababababab
abababaqaqaqaqaqaqaqaqaqaqaqaqaqaqaqacabababababababababafababababababababababababababababababababab
ababayazaAaAaAaAaAaAaAaAaAaAaAaAaAazaBababaLaSaSababaCabafababababababababababababababababababababab
ababayazagahahahahahahahahahahahaiazaBaCababaDabaDababaCafababababababababababababababababababababab
ababayazajakalalalalalalalalalamanazaEaFaFaFaFaqaFaFaFadafabababbdababbeabababababababababababababab
ababayazajanaoaoaoaoaoaoaoaoaoajanaAaAaAaAaAaAaAaAaAazaGabababababababababababababababababababababab
ababayazajanabababababababababajarahahahahahahahahasazaGabababababababababababababababababababababab
ababayazajanabababababababababajakalalalalalalalalatazaGabababababababababababababababababababababab
ababayazajanabababababababababajanaHaHaHaHaHaHaHaHaHazaGababababbgababababababababababababababababab
ababayazajanaeaeaeaeaeaeaeaeaeajanazaIaJaJaJaJaJaJaJaJababababababababababababababababababababababab
ababayazajauahahahahahahahahahavanazaGababababababababababababababababbhabababababababababababababab
ababayazagalalalawaxalalalalalalaiazaGababababababababababababababababababababababababababababababab
ababayazaHaHaHaHajanaHaHaHaHaHaHaHazaGababababababbkabababababababababababababababababababababababab
abababaJaJaJaKazajanazaIaJaJaJaJaJaJabababababababababababababababababababababababababababababababab
ababababababayazajanazaGabababababababababababababababababababababababababababababababababababababab
ababababababayazajanazaGabababababababababababababababababababababababababababababababababababababab
ababababababayazajanazaGabababababababababababababababababababababababababababababababababababababab
ababababababayazazazazaGabababababababababababababababababababababababababababababababababababababab
abababababababaJaJaJaJababababababababababababababababababababababababababababababababababababababab
abababababababababababababababababababababababababababababababababababababababababababababababababab
abababababababababababababababababababababababababababababababababababababababababababababababababab
abababababababababababababababababababababababababababababababababababababababababababababababababab
abababababababababababababababababababababababababababababababababababababababababababababababababab
abababababababababababababababababababababababababababababababababababababababababababababababababab
abababababababababababababababababababababababababababababababababababababababababababababababababab
"}

(1,1,2) = {"
aaaaaaaaaaaaaaaaaaaaaaaaaaaaaaaaaaaaaaaaaaaaaaaaaaaaaaaaaaaaaaaaaaaaaaaaaaaaaaaaaaaaaaaaaaaaaaaaaaaa
aaaaaaaaaaaaaaaaaaaaaaaaaaaaaaaaaaaaaaaaaaaaaaaaaaaaaaaaaaaaaaaaaaaaaaaaaaaaaaaaaaaaaaaaaaaaaaaaaaaa
aaaaaaaaaaaaaaaaaaaaaaaaaaaaaaaaaaaaaaaaaaaaaaaaaaaaaaaaaaaaaaaaaaaaaaaaaaaaaaaaaaaaaaaaaaaaaaaaaaaa
aaaaaaaaaaaaaaaaaaaaaaaaaaaaaaaaaaaaaaaaaaaaaaaaaaaaaaaaaaaaaaaaaaaaaaaaaaaaaaaaaaaaaaaaaaaaaaaaaaaa
aaaaaaaaaaaaaaaaaaaaaaaaaaaaaaaaaaaaaaaaaaaaaaaaaaaaaaaaaaaaaaaaaaaaaaaaaaaaaaaaaaaaaaaaaaaaaaaaaaaa
aaaaaaaaaaaaaaaaaaaaaaaaaaaaaaaaaaaaaaaaaaaaaaaaaaaaaaaaaaaaaaaaaaaaaaaaaaaaaaaaaaaaaaaaaaaaaaaaaaaa
aaaaaaaaaaaaaaaaaaaaaaaaaaaaaaaaaaaaaaaaaaaaaaaaaaaaaaaaaaaaaaaaaaaaaaaaaaaaaaaaaaaaaaaaaaaaaaaaaaaa
aaaaaaaaaaaaaaaaaaaaaaaaaaaaaaaaaaaaaaaaaaaaaaaaaaaaaaaaaaaaaaaaaaaaaaaaaaaaaaaaaaaaaaaaaaaaaaaaaaaa
aaaaaaaaaaaaaaaaaaaaaaaaaaaaaaaaaaaaaaaaaaaaaaaaaaaaaaaaaaaaaaaaaaaaaaaaaaaaaaaaaaaaaaaaaaaaaaaaaaaa
aaaaaaaaaaaaaaaaaaaaaaaaaaaaaaaaaaaaaaaaaaaaaaaaaaaaaaaaaaaaaaaaaaaaaaaaaaaaaaaaaaaaaaaaaaaaaaaaaaaa
aaaaaaaaaaaaaaaaaaaaaaaaaaaaaaaaaaaaaaaaaaaaaaaaaaaaaaaaaaaaaaaaaaaaaaaaaaaaaaaaaaaaaaaaaaaaaaaaaaaa
aaaaaaaaaaaaaaaaaaaaaaaaaaaaaaaaaaaaaaaaaaaaaaaaaaaaaaaaaaaaaaaaaaaaaaaaaaaaaaaaaaaaaaaaaaaaaaaaaaaa
aaaaaaaaaaaaaaaaaaaaaaaaaaaaaaaaaaaaaaaaaaaaaaaaaaaaaaaaaaaaaaaaaaaaaaaaaaaaaaaaaaaaaaaaaaaaaaaaaaaa
aaaaaaaaaaaaaaaaaaaaaaaaaaaaaaaaaaaaaaaaaaaaaaaaaaaaaaaaaaaaaaaaaaaaaaaaaaaaaaaaaaaaaaaaaaaaaaaaaaaa
aaaaaaaaaaaaaaaaaaaaaaaaaaaaaaaaaaaaaaaaaaaaaaaaaaaaaaaaaaaaaaaaaaaaaaaaaaaaaaaaaaaaaaaaaaaaaaaaaaaa
aaaaaaaaaaaaaaaaaaaaaaaaaaaaaaaaaaaaaaaaaaaaaaaaaaaaaaaaaaaaaaaaaaaaaaaaaaaaaaaaaaaaaaaaaaaaaaaaaaaa
aaaaaaaaaaaaaaaaaaaaaaaaaaaaaaaaaaaaaaaaaaaaaaaaaaaaaaaaaaaaaaaaaaaaaaaaaaaaaaaaaaaaaaaaaaaaaaaaaaaa
aaaaaaaaaaaaaaaaaaaaaaaaaaaaaaaaaaaaaaaaaaaaaaaaaaaaaaaaaaaaaaaaaaaaaaaaaaaaaaaaaaaaaaaaaaaaaaaaaaaa
aaaaaaaaaaaaaaaaaaaaaaaaaaaaaaaaaaaaaaaaaaaaaaaaaaaaaaaaaaaaaaaaaaaaaaaaaaaaaaaaaaaaaaaaaaaaaaaaaaaa
aaaaaaaaaaaaaaaaaaaaaaaaaaaaaaaaaaaaaaaaaaaaaaaaaaaaaaaaaaaaaaaaaaaaaaaaaaaaaaaaaaaaaaaaaaaaaaaaaaaa
aaaaaaaaaaaaaaaaaaaaaaaaaaaaaaaaaaaaaaaaaaaaaaaaaaaaaaaaaaaaaaaaaaaaaaaaaaaaaaaaaaaaaaaaaaaaaaaaaaaa
aaaaaaaaaaaaaaaaaaaaaaaaaaaaaaaaaaaaaaaaaaaaaaaaaaaaaaaaaaaaaaaaaaaaaaaaaaaaaaaaaaaaaaaaaaaaaaaaaaaa
aaaaaaaaaaaaaaaaaaaaaaaaaaaaaaaaaaaaaaaaaaaaaaaaaaaaaaaaaaaaaaaaaaaaaaaaaaaaaaaaaaaaaaaaaaaaaaaaaaaa
aaaaaaaaaaaaaaaaaaaaaaaaaaaaaaaaaaaaaaaaaaaaaaaaaaaaaaaaaaaaaaaaaaaaaaaaaaaaaaaaaaaaaaaaaaaaaaaaaaaa
aaaaaaaaaaaaaaaaaaaaaaaaaaaaaaaaaaaaaaaaaaaaaaaaaaaaaaaaaaaaaaaaaaaaaaaaaaaaaaaaaaaaaaaaaaaaaaaaaaaa
aaaaaaaaaaaaaaaaaaaaaaaaaaaaaaaaaaaaaaaaaaaaaaaaaaaaaaaaaaaaaaaaaaaaaaaaaaaaaaaaaaaaaaaaaaaaaaaaaaaa
aaaaaaaaaaaaaaaaaaaaaaaaaaaaaaaaaaaaaaaaaaaaaaaaaaaaaaaaaaaaaaaaaaaaaaaaaaaaaaaaaaaaaaaaaaaaaaaaaaaa
aaaaaaaaaaaaaaaaaaaaaaaaaaaaaaaaaaaaaaaaaaaaaaaaaaaaaaaaaaaaaaaaaaaaaaaaaaaaaaaaaaaaaaaaaaaaaaaaaaaa
aaaaaaaaaaaaaaaaaaaaaaaaaaaaaaaaaaaaaaaaaaaaaaaaaaaaaaaaaaaaaaaaaaaaaaaaaaaaaaaaaaaaaaaaaaaaaaaaaaaa
aaaaaaaaaaaaaaaaaaaaaaaaaaaaaaaaaaaaaaaaaaaaaaaaaaaaaaaaaaaaaaaaaaaaaaaaaaaaaaaaaaaaaaaaaaaaaaaaaaaa
aaaUaUaUaUaUaUaaaaaaaaaaaUaUaUaUaUaUaaaaaaaaaaaaaaaaaaaaaaaaaaaaaaaaaaaaaaaaaaaaaaaaaaaaaaaaaaaaaaaa
aaaUaMaNaNaNaVaUaUaUaUaUaWaNaNaNaOaUaaaaaaaaaaaaaaaaaaaaaaaaaaaaaaaaaaaaaaaaaaaaaaaaaaaaaaaaaaaaaaaa
aaaUaPaQaQaQaNaNaNaNaNaNaNaQaQaQaRaUaaaaaaaaaaaaaaaaaaaaaaaaaaaaaaaaaaaaaaaaaaaaaaaaaaaaaaaaaaaaaaaa
aaaUaPaQaQaQaQaQaQaQaQaQaQaQaQaQaRaUaaaaaaaaaaaaaaaaaaaaaaaaaaaaaaaaaaaaaaaaaaaaaaaaaaaaaaaaaaaaaaaa
aaaUaPaXaQaQaYaQaQaZaQaQaQaQaQaQaRaUaaaaaaaaaaaaaaaaaaaaaaaaaaaaaaaaaaaaaaaaaaaaaaaaaaaaaaaaaaaaaaaa
aaaUaPaQaQaQaQaQaQaQaQaQaQbiaQaQaRaUaaaaaaaaaaaaaaaaaaaaaaaaaaaaaaaaaaaaaaaaaaaaaaaaaaaaaaaaaaaaaaaa
aaaUaPaQaQaQaQaQaQaQaQaQaQaQaQaQaRaUaaaaaaaaaaaaaaaaaaaaaaaaaaaaaaaaaaaaaaaaaaaaaaaaaaaaaaaaaaaaaaaa
aaaUaPaQaQaQaQaQaQaQaQaQaQaQaQaQaRaUaaaaaaaaaaaaaaaaaaaaaaaaaaaaaaaaaaaaaaaaaaaaaaaaaaaaaaaaaaaaaaaa
aaaUaPbaaQaQbbaQaQbcaQaQaQaQaQbjaRaUaaaaaaaaaaaaaaaaaaaaaaaaaaaaaaaaaaaaaaaaaaaaaaaaaaaaaaaaaaaaaaaa
aaaUaNaNaNaNaPaQaQaQaQaQaRaNaNaNaNaUaaaaaaaaaaaaaaaaaaaaaaaaaaaaaaaaaaaaaaaaaaaaaaaaaaaaaaaaaaaaaaaa
aaaUaUaUaUaUaNaNaNaTaNaNaNaUaUaUaUaUaaaaaaaaaaaaaaaaaaaaaaaaaaaaaaaaaaaaaaaaaaaaaaaaaaaaaaaaaaaaaaaa
aaaaaaaaaaaUaUaUaUaUaUaUaUaUaaaaaaaaaaaaaaaaaaaaaaaaaaaaaaaaaaaaaaaaaaaaaaaaaaaaaaaaaaaaaaaaaaaaaaaa
aaaaaaaaaaaaaaaaaaaaaaaaaaaaaaaaaaaaaaaaaaaaaaaaaaaaaaaaaaaaaaaaaaaaaaaaaaaaaaaaaaaaaaaaaaaaaaaaaaaa
aaaaaaaaaaaaaaaaaaaaaaaaaaaaaaaaaaaaaaaaaaaaaaaaaaaaaaaaaaaaaaaaaaaaaaaaaaaaaaaaaaaaaaaaaaaaaaaaaaaa
aaaaaaaaaaaaaaaaaaaaaaaaaaaaaaaaaaaaaaaaaaaaaaaaaaaaaaaaaaaaaaaaaaaaaaaaaaaaaaaaaaaaaaaaaaaaaaaaaaaa
aaaaaaaaaaaaaaaaaaaaaaaaaaaaaaaaaaaaaaaaaaaaaaaaaaaaaaaaaaaaaaaaaaaaaaaaaaaaaaaaaaaaaaaaaaaaaaaaaaaa
aaaaaaaaaaaaaaaaaaaaaaaaaaaaaaaaaaaaaaaaaaaaaaaaaaaaaaaaaaaaaaaaaaaaaaaaaaaaaaaaaaaaaaaaaaaaaaaaaaaa
aaaaaaaaaaaaaaaaaaaaaaaaaaaaaaaaaaaaaaaaaaaaaaaaaaaaaaaaaaaaaaaaaaaaaaaaaaaaaaaaaaaaaaaaaaaaaaaaaaaa
aaaaaaaaaaaaaaaaaaaaaaaaaaaaaaaaaaaaaaaaaaaaaaaaaaaaaaaaaaaaaaaaaaaaaaaaaaaaaaaaaaaaaaaaaaaaaaaaaaaa
aaaaaaaaaaaaaaaaaaaaaaaaaaaaaaaaaaaaaaaaaaaaaaaaaaaaaaaaaaaaaaaaaaaaaaaaaaaaaaaaaaaaaaaaaaaaaaaaaaaa
"}

(1,1,3) = {"
aaaaaaaaaaaaaaaaaaaaaaaaaaaaaaaaaaaaaaaaaaaaaaaaaaaaaaaaaaaaaaaaaaaaaaaaaaaaaaaaaaaaaaaaaaaaaaaaaaaa
aaaaaaaaaaaaaaaaaaaaaaaaaaaaaaaaaaaaaaaaaaaaaaaaaaaaaaaaaaaaaaaaaaaaaaaaaaaaaaaaaaaaaaaaaaaaaaaaaaaa
aaaaaaaaaaaaaaaaaaaaaaaaaaaaaaaaaaaaaaaaaaaaaaaaaaaaaaaaaaaaaaaaaaaaaaaaaaaaaaaaaaaaaaaaaaaaaaaaaaaa
aaaaaaaaaaaaaaaaaaaaaaaaaaaaaaaaaaaaaaaaaaaaaaaaaaaaaaaaaaaaaaaaaaaaaaaaaaaaaaaaaaaaaaaaaaaaaaaaaaaa
aaaaaaaaaaaaaaaaaaaaaaaaaaaaaaaaaaaaaaaaaaaaaaaaaaaaaaaaaaaaaaaaaaaaaaaaaaaaaaaaaaaaaaaaaaaaaaaaaaaa
aaaaaaaaaaaaaaaaaaaaaaaaaaaaaaaaaaaaaaaaaaaaaaaaaaaaaaaaaaaaaaaaaaaaaaaaaaaaaaaaaaaaaaaaaaaaaaaaaaaa
aaaaaaaaaaaaaaaaaaaaaaaaaaaaaaaaaaaaaaaaaaaaaaaaaaaaaaaaaaaaaaaaaaaaaaaaaaaaaaaaaaaaaaaaaaaaaaaaaaaa
aaaaaaaaaaaaaaaaaaaaaaaaaaaaaaaaaaaaaaaaaaaaaaaaaaaaaaaaaaaaaaaaaaaaaaaaaaaaaaaaaaaaaaaaaaaaaaaaaaaa
aaaaaaaaaaaaaaaaaaaaaaaaaaaaaaaaaaaaaaaaaaaaaaaaaaaaaaaaaaaaaaaaaaaaaaaaaaaaaaaaaaaaaaaaaaaaaaaaaaaa
aaaaaaaaaaaaaaaaaaaaaaaaaaaaaaaaaaaaaaaaaaaaaaaaaaaaaaaaaaaaaaaaaaaaaaaaaaaaaaaaaaaaaaaaaaaaaaaaaaaa
aaaaaaaaaaaaaaaaaaaaaaaaaaaaaaaaaaaaaaaaaaaaaaaaaaaaaaaaaaaaaaaaaaaaaaaaaaaaaaaaaaaaaaaaaaaaaaaaaaaa
aaaaaaaaaaaaaaaaaaaaaaaaaaaaaaaaaaaaaaaaaaaaaaaaaaaaaaaaaaaaaaaaaaaaaaaaaaaaaaaaaaaaaaaaaaaaaaaaaaaa
aaaaaaaaaaaaaaaaaaaaaaaaaaaaaaaaaaaaaaaaaaaaaaaaaaaaaaaaaaaaaaaaaaaaaaaaaaaaaaaaaaaaaaaaaaaaaaaaaaaa
aaaaaaaaaaaaaaaaaaaaaaaaaaaaaaaaaaaaaaaaaaaaaaaaaaaaaaaaaaaaaaaaaaaaaaaaaaaaaaaaaaaaaaaaaaaaaaaaaaaa
aaaaaaaaaaaaaaaaaaaaaaaaaaaaaaaaaaaaaaaaaaaaaaaaaaaaaaaaaaaaaaaaaaaaaaaaaaaaaaaaaaaaaaaaaaaaaaaaaaaa
aaaaaaaaaaaaaaaaaaaaaaaaaaaaaaaaaaaaaaaaaaaaaaaaaaaaaaaaaaaaaaaaaaaaaaaaaaaaaaaaaaaaaaaaaaaaaaaaaaaa
aaaaaaaaaaaaaaaaaaaaaaaaaaaaaaaaaaaaaaaaaaaaaaaaaaaaaaaaaaaaaaaaaaaaaaaaaaaaaaaaaaaaaaaaaaaaaaaaaaaa
aaaaaaaaaaaaaaaaaaaaaaaaaaaaaaaaaaaaaaaaaaaaaaaaaaaaaaaaaaaaaaaaaaaaaaaaaaaaaaaaaaaaaaaaaaaaaaaaaaaa
aaaaaaaaaaaaaaaaaaaaaaaaaaaaaaaaaaaaaaaaaaaaaaaaaaaaaaaaaaaaaaaaaaaaaaaaaaaaaaaaaaaaaaaaaaaaaaaaaaaa
aaaaaaaaaaaaaaaaaaaaaaaaaaaaaaaaaaaaaaaaaaaaaaaaaaaaaaaaaaaaaaaaaaaaaaaaaaaaaaaaaaaaaaaaaaaaaaaaaaaa
aaaaaaaaaaaaaaaaaaaaaaaaaaaaaaaaaaaaaaaaaaaaaaaaaaaaaaaaaaaaaaaaaaaaaaaaaaaaaaaaaaaaaaaaaaaaaaaaaaaa
aaaaaaaaaaaaaaaaaaaaaaaaaaaaaaaaaaaaaaaaaaaaaaaaaaaaaaaaaaaaaaaaaaaaaaaaaaaaaaaaaaaaaaaaaaaaaaaaaaaa
aaaaaaaaaaaaaaaaaaaaaaaaaaaaaaaaaaaaaaaaaaaaaaaaaaaaaaaaaaaaaaaaaaaaaaaaaaaaaaaaaaaaaaaaaaaaaaaaaaaa
aaaaaaaaaaaaaaaaaaaaaaaaaaaaaaaaaaaaaaaaaaaaaaaaaaaaaaaaaaaaaaaaaaaaaaaaaaaaaaaaaaaaaaaaaaaaaaaaaaaa
aaaaaaaaaaaaaaaaaaaaaaaaaaaaaaaaaaaaaaaaaaaaaaaaaaaaaaaaaaaaaaaaaaaaaaaaaaaaaaaaaaaaaaaaaaaaaaaaaaaa
aaaaaaaaaaaaaaaaaaaaaaaaaaaaaaaaaaaaaaaaaaaaaaaaaaaaaaaaaaaaaaaaaaaaaaaaaaaaaaaaaaaaaaaaaaaaaaaaaaaa
aaaaaaaaaaaaaaaaaaaaaaaaaaaaaaaaaaaaaaaaaaaaaaaaaaaaaaaaaaaaaaaaaaaaaaaaaaaaaaaaaaaaaaaaaaaaaaaaaaaa
aaaaaaaaaaaaaaaaaaaaaaaaaaaaaaaaaaaaaaaaaaaaaaaaaaaaaaaaaaaaaaaaaaaaaaaaaaaaaaaaaaaaaaaaaaaaaaaaaaaa
aaaaaaaaaaaaaaaaaaaaaaaaaaaaaaaaaaaaaaaaaaaaaaaaaaaaaaaaaaaaaaaaaaaaaaaaaaaaaaaaaaaaaaaaaaaaaaaaaaaa
aaaaaaaaaaaaaaaaaaaaaaaaaaaaaaaaaaaaaaaaaaaaaaaaaaaaaaaaaaaaaaaaaaaaaaaaaaaaaaaaaaaaaaaaaaaaaaaaaaaa
aaaaaaaaaaaaaaaaaaaaaaaaaaaaaaaaaaaaaaaaaaaaaaaaaaaaaaaaaaaaaaaaaaaaaaaaaaaaaaaaaaaaaaaaaaaaaaaaaaaa
aaaaaaaaaaaaaaaaaaaaaaaaaaaaaaaaaaaaaaaaaaaaaaaaaaaaaaaaaaaaaaaaaaaaaaaaaaaaaaaaaaaaaaaaaaaaaaaaaaaa
aaaaaaaaaaaaaaaaaaaaaaaaaaaaaaaaaaaaaaaaaaaaaaaaaaaaaaaaaaaaaaaaaaaaaaaaaaaaaaaaaaaaaaaaaaaaaaaaaaaa
aaaaaaaaaaaaaaaaaaaaaaaaaaaaaaaaaaaaaaaaaaaaaaaaaaaaaaaaaaaaaaaaaaaaaaaaaaaaaaaaaaaaaaaaaaaaaaaaaaaa
aaaaaaaaaaaaaaaaaaaaaaaaaaaaaaaaaaaaaaaaaaaaaaaaaaaaaaaaaaaaaaaaaaaaaaaaaaaaaaaaaaaaaaaaaaaaaaaaaaaa
aaaaaaaaaaaaaaaaaaaaaaaaaaaaaaaaaaaaaaaaaaaaaaaaaaaaaaaaaaaaaaaaaaaaaaaaaaaaaaaaaaaaaaaaaaaaaaaaaaaa
aaaaaaaaaaaaaaaaaaaaaaaaaaaaaaaaaaaaaaaaaaaaaaaaaaaaaaaaaaaaaaaaaaaaaaaaaaaaaaaaaaaaaaaaaaaaaaaaaaaa
aaaaaaaaaaaaaaaaaaaaaaaaaaaaaaaaaaaaaaaaaaaaaaaaaaaaaaaaaaaaaaaaaaaaaaaaaaaaaaaaaaaaaaaaaaaaaaaaaaaa
aaaaaaaaaaaaaaaaaaaaaaaaaaaaaaaaaaaaaaaaaaaaaaaaaaaaaaaaaaaaaaaaaaaaaaaaaaaaaaaaaaaaaaaaaaaaaaaaaaaa
aaaaaaaaaaaaaaaaaaaaaaaaaaaaaaaaaaaaaaaaaaaaaaaaaaaaaaaaaaaaaaaaaaaaaaaaaaaaaaaaaaaaaaaaaaaaaaaaaaaa
aaaaaaaaaaaaaaaaaaaaaaaaaaaaaaaaaaaaaaaaaaaaaaaaaaaaaaaaaaaaaaaaaaaaaaaaaaaaaaaaaaaaaaaaaaaaaaaaaaaa
aaaaaaaaaaaaaaaaaaaaaaaaaaaaaaaaaaaaaaaaaaaaaaaaaaaaaaaaaaaaaaaaaaaaaaaaaaaaaaaaaaaaaaaaaaaaaaaaaaaa
aaaaaaaaaaaaaaaaaaaaaaaaaaaaaaaaaaaaaaaaaaaaaaaaaaaaaaaaaaaaaaaaaaaaaaaaaaaaaaaaaaaaaaaaaaaaaaaaaaaa
aaaaaaaaaaaaaaaaaaaaaaaaaaaaaaaaaaaaaaaaaaaaaaaaaaaaaaaaaaaaaaaaaaaaaaaaaaaaaaaaaaaaaaaaaaaaaaaaaaaa
aaaaaaaaaaaaaaaaaaaaaaaaaaaaaaaaaaaaaaaaaaaaaaaaaaaaaaaaaaaaaaaaaaaaaaaaaaaaaaaaaaaaaaaaaaaaaaaaaaaa
aaaaaaaaaaaaaaaaaaaaaaaaaaaaaaaaaaaaaaaaaaaaaaaaaaaaaaaaaaaaaaaaaaaaaaaaaaaaaaaaaaaaaaaaaaaaaaaaaaaa
aaaaaaaaaaaaaaaaaaaaaaaaaaaaaaaaaaaaaaaaaaaaaaaaaaaaaaaaaaaaaaaaaaaaaaaaaaaaaaaaaaaaaaaaaaaaaaaaaaaa
aaaaaaaaaaaaaaaaaaaaaaaaaaaaaaaaaaaaaaaaaaaaaaaaaaaaaaaaaaaaaaaaaaaaaaaaaaaaaaaaaaaaaaaaaaaaaaaaaaaa
bfbfaaaaaaaaaaaaaaaaaaaaaaaaaaaaaaaaaaaaaaaaaaaaaaaaaaaaaaaaaaaaaaaaaaaaaaaaaaaaaaaaaaaaaaaaaaaaaaaa
bfbfaaaaaaaaaaaaaaaaaaaaaaaaaaaaaaaaaaaaaaaaaaaaaaaaaaaaaaaaaaaaaaaaaaaaaaaaaaaaaaaaaaaaaaaaaaaaaaaa
"}
